100_001_002_003_100_004_005_006_000_010_011_012_100_100_004_005_006_100_004_005_006_001_002_003_100_001_002_003_100_004_005_006_001_002_003_100_017_100_001_002_002_003_004_005_006_100_001_002_003_017_100_100_004_005_006_001_002_002_003_100_100_100_009_100_100_013_001_002_003_000_010_011_012_017_100_004_005_006_100_100_100_001_002_003_100_100_100_100_100_100_100_100_100_100_100_100_100_100_100_100_100_100_100_100_100_100_100_100_100_100_
003_004_005_006_100_017_100_100_009_100_100_013_010_011_012_100_100_100_100_100_100_004_005_006_100_004_005_006_100_017_100_100_004_005_006_017_100_100_004_005_005_006_100_100_017_100_004_005_006_100_001_002_003_100_100_004_005_005_006_100_017_001_008_100_100_014_004_005_006_009_100_100_013_010_011_012_100_100_100_017_100_004_005_006_001_002_003_017_100_100_100_100_100_100_100_100_100_017_100_100_100_100_100_100_100_100_017_100_100_100_
006_017_100_100_001_002_003_017_008_100_100_014_100_100_013_017_100_000_010_011_012_017_020_021_001_002_003_017_100_100_001_002_003_100_100_025_027_001_002_003_100_100_000_010_011_012_100_001_002_003_004_005_006_100_100_100_100_100_100_100_100_004_008_100_000_010_011_012_017_007_100_100_014_100_100_013_017_100_100_100_100_100_100_100_004_005_006_100_100_100_100_100_100_100_100_100_100_100_100_100_100_017_100_100_100_100_100_100_100_017_
002_003_020_021_004_005_006_001_008_020_021_014_100_100_014_002_003_009_100_100_013_100_022_023_004_005_006_001_002_003_004_005_006_100_001_028_030_004_005_006_100_100_009_049_100_013_100_004_005_006_100_100_100_017_001_002_003_100_100_001_002_003_008_100_009_020_021_013_020_021_100_000_010_011_012_015_100_100_100_100_100_017_100_100_100_100_100_100_001_002_003_100_100_100_100_100_100_100_100_100_100_100_100_048_048_048_048_048_048_048_
005_006_022_023_100_100_100_004_007_022_023_010_011_012_014_005_006_007_100_100_015_018_023_024_018_018_018_004_005_006_100_100_023_100_004_028_030_100_100_100_020_021_008_050_100_014_023_100_100_100_025_027_100_100_025_026_027_100_100_004_005_006_008_100_007_023_053_015_022_023_100_054_100_100_013_025_026_026_026_035_100_100_100_100_001_002_003_100_004_005_006_100_100_100_100_100_100_100_100_100_042_043_045_045_045_045_045_045_045_045_
019_018_023_024_018_100_100_018_018_023_024_018_018_013_016_018_018_018_025_026_026_026_026_026_026_025_027_019_018_018_018_100_024_021_018_028_030_019_018_018_023_023_008_051_100_014_024_021_019_025_029_030_002_003_028_029_029_027_019_019_018_100_007_018_019_024_023_019_023_024_018_018_019_025_026_029_029_038_036_037_100_001_002_003_004_005_006_100_100_100_100_100_100_017_100_100_100_100_042_043_045_045_045_045_045_045_045_045_045_045_
026_034_034_034_026_026_026_027_026_026_026_026_026_026_026_026_026_026_029_032_029_032_032_032_029_028_029_034_026_027_026_026_034_034_034_032_032_034_034_034_034_026_034_034_034_034_034_034_034_029_029_030_005_006_028_029_029_032_034_034_034_034_026_034_026_034_034_034_034_026_026_026_026_029_029_029_038_039_041_100_100_004_005_006_100_100_100_100_100_100_100_100_100_100_100_100_100_017_100_044_046_046_046_047_043_045_045_045_045_045_
031_033_033_033_031_032_031_030_032_031_032_029_032_031_033_031_032_031_031_033_031_033_033_033_031_028_031_033_031_032_027_031_033_033_033_033_033_033_033_033_033_031_033_033_033_033_033_033_033_031_032_030_052_052_028_032_031_033_033_033_033_033_031_033_031_033_033_033_033_031_029_032_032_031_032_038_039_040_041_052_052_052_052_052_052_052_052_052_052_052_052_052_052_052_052_052_052_052_052_044_046_046_046_046_044_046_046_046_046_046_