004_005_006_100_100_004_005_006_055_097_077_093_077_093_097_098_077_077_098_077_097_077_077_093_077_094_077_098_077_095_001_002_003_100_001_002_003_100_055_097_077_098_097_097_098_077_093_077_094_077_098_077_097_098_093_077_077_093_077_077_093_077_066_099_067_077_098_094_098_077_077_086_075_100_075_057_077_077_094_028_
003_100_100_017_001_002_003_056_077_093_094_098_098_098_097_077_098_097_077_094_077_093_077_077_097_077_077_094_077_095_004_005_006_100_004_005_006_056_077_098_094_077_094_077_093_077_077_097_077_094_077_094_077_077_077_093_077_077_097_098_077_097_066_099_099_065_094_077_077_093_077_068_100_100_100_062_094_098_077_028_
006_001_002_003_004_005_006_056_077_077_077_077_093_077_077_077_077_077_077_077_087_087_077_094_077_087_092_092_086_100_100_100_001_002_003_100_100_056_077_077_077_077_086_069_065_058_065_087_087_077_093_077_087_092_097_077_094_077_077_058_065_058_099_099_099_099_088_078_065_092_086_068_100_100_100_062_057_077_092_028_
100_004_005_006_100_001_002_003_057_058_059_065_086_069_059_065_086_069_065_058_068_062_065_092_058_083_081_085_100_001_002_003_004_005_006_100_100_100_057_058_059_059_068_090_099_099_099_068_062_065_092_058_083_079_065_086_069_065_058_099_099_099_099_079_079_081_085_091_079_099_068_068_100_100_100_062_062_059_099_028_
001_002_003_100_100_004_005_006_100_060_061_084_068_090_099_073_068_090_073_074_068_062_079_099_081_083_100_100_100_004_005_006_100_100_100_100_100_100_100_060_061_084_068_063_060_099_061_068_062_084_079_073_083_100_084_068_063_091_081_085_091_081_099_100_100_100_100_072_100_060_068_068_100_049_100_062_062_079_073_028_
004_023_006_100_017_100_100_100_100_100_017_100_068_063_085_070_068_063_070_080_068_062_100_025_026_026_027_100_100_100_100_100_100_100_100_020_021_100_100_100_100_100_068_076_100_099_100_068_062_100_100_070_083_100_100_068_076_072_100_100_072_100_099_100_100_100_100_072_100_100_068_068_100_050_100_062_062_100_070_028_
100_024_021_100_001_002_003_017_018_100_018_019_068_064_019_071_068_064_071_019_068_062_019_028_029_029_030_019_019_018_018_019_019_018_100_023_023_018_018_019_018_019_068_064_019_082_019_068_025_026_027_071_083_019_019_068_064_089_019_019_089_019_082_019_019_019_019_089_019_019_068_068_100_051_100_062_062_019_071_028_
026_026_026_026_026_026_026_026_026_026_026_026_026_026_026_026_026_026_026_026_026_026_026_029_029_029_029_026_026_026_026_026_026_026_026_026_026_026_026_026_026_026_026_026_026_026_026_026_029_029_029_026_026_026_026_026_026_026_026_026_026_026_026_026_026_026_026_026_026_026_026_026_026_026_026_026_026_026_026_026_